P 1 3 8 1 4 2
P 2 7 5 1 3 2
P 3 5 8 1 2 2
P 4 0 8 1 1 2
P 5 3 3 1 0 1
P 6 10 9 1 0 1
P 7 2 3 1 0 1
P 8 7 6 1 0 1
P 9 0 2 1 0 1
P 10 9 10 1 0 1
