P 1 1 3 1 2 2
P 2 7 4 1 1 2
P 3 5 0 1 0 1
P 4 4 7 1 0 1
P 5 3 7 1 0 1
